00000000000000000000
00000000000000000000
0000#####00000000000
0000#000#00000000000
0000#x00#00000000000
00###00x##0000000000
00#00x0x0#0000000000
###0#0##0#000######0
#000#0##0#####00pp#0
#0x00x0000000000pp#0
#####0###0#0##00pp#0
0000#00000#########0
0000#######000000000
00000000000000000000