0000#######00000000
000##000j0#00000000
0000#00000#00000000
0000000000#00000000
0000#00000#00000000
0000#00000#####0000
0000#0x00000p0#0000
0000#0x000000p#0000
0000#0x0000p0p#0000
0000#00000000p#0000
0000#0xxxx0p0p#0000
0000#0000x0ppp#0000
0000#0000x0000#0000
0000#000000000#0000
0000####0######0000
0000000000000000000
0000000000000000000