00000000000########
00000000000#00pppp#
############00pppp#
#0000#00x0x000pppp#
#0xxx#x00x0#00pppp#
#00x00000x0#00pppp#
#0xx0#x0x0x########
#00x0#00000#0000000
##0#########0000000
#0000#0000##0000000
#00000x000##0000000
#00xx#xx000#0000000
#0000#0000##0000000
###########00000000