0000000000000000000
00000000#####000000
00000000#000#####00
00000000#0#x##00#00
00000000#00000x0#00
#########0###000#00
#pppp00##0x00x###00
#pppp0000x0xx0##000
#pppp00##x00x00#000
#########00x00##000
00000000#0x0x00#000
00000000###0##0#000
0000000000#0000#000
0000000000######000