0###00#############
##j####0000000#000#
#0xx000xx00x0x0ppp#
#00xxx#0000x00#ppp#
#0x000#0xx0xx0#ppp#
###000#00x0000#ppp#
#00000#0x0x0x0#ppp#
#0000######0###ppp#
##0#00#00x0x00#ppp#
#00##0#0xx0x0x##pp#
#0pp#0#00x000000#p#
#0pp#0#0xxx0xxx0#p#
#####0#0000000#0#p#
0000#0#########0#p#
0000#00000000000#p#
0000###############
0000000000000000000